####															####
####															####
####															####
####															####
####															####
####															####
####															####
####															####
####															####
####								^^^^							####
####															####
####								  @ @							####
####								##########						####
####								##########						####
####						  ^^^^ @			**					####
####						############		##########					####
####						############		##########					####
####					  @ **						@				####
####					#######				##########				####
####					#######				##########				####	    
####										    		^^^^^^			####
####				^^						    		   ***			####
####			  @ #######					^^^^^^ @ @	    	@ @			####
####	        ****** ##############					#################################		####		    
####      	###########################  			###########################################		####
####										    					####  P
####		 												    	####   
########################################################################################################################
########################################################################################################################
########################################################################################################################

