                                                  
                                                  
                         ##                       
          ###    #      ##                        
   #            ##     ##                         
P  #   #       ###    ##                          
##### ############################################
##### ############################################
##################################################
##################################################
