####                                    ####
####       **                           ####
####             * * * * *              ####
####   ^^  @*   ^^          ^^^^^       ####
####   ^^#### @*         * * * *   ^    ####
####** ^^    ####  @@   * * * *   * ^ * ####
####** @@        ################       ####
####  ###                       #^*^*^*^####
####^^     *                    #^*^*^*^####
#############^                  #^*^*^*^####
####        ## *  ^@ ****     **#^*^*^*^####
####         #############    **#^*^*^*^####
####           **        #^   **#^*^*^*^####
####  **    ^@         ^^##@  ^^#^*^*^*^####
####* *^*   ######^    *^###  **#^*^*^*^####
####**^          ##^   *^#    *@#^*^*^*^####
#### @^ ^         ##     #    ###^*^*^*^####
######****        ***  ***     ^#^*^*^*^####
##########  * ^##################     **####
####         #####  ^ ^ ^ ^ ^ ^      #######
#### P ^*^*@   **  * * * * * * *     @@ ####
############################################
############################################
############################################
